11
+-+-+-+-+-+
  |       |
+ +-+-+ + +
| |     | |
+ + + + + +
|   | |   |
+-+-+ +-+-+
|     |   |
+ + +-+ + +
| |     |  
+-+-+-+-+-+